ceil(x) 	Retorna o menor inteiro maior ou igual a x.
copysign(x, y) 	Retorna x com o sinal de y
fabs(x) 	Retorna o valor absoluto de x
factorial(x) 	Retorna o fatorial de x
floor(x) 	Retorna o maior inteiro menor ou igual a x
fmod(x, y) 	Retorna o resto quando x é dividido por y
frexp(x) 	Retorna a mantissa e o expoente de x como o par (m, e)
fsum(iterable) 	Retorna uma soma precisa em ponto flutuante dos valores no iterável
isfinite(x) 	Retorna True se x não é infinito nem NaN (não é um número)
isinf(x) 	Retorna True se x for um infinito positivo ou negativo
isnan(x) 	Retorna True se x for um NaN
ldexp(x,i) 	Retorna x * (2**i)
modf(x) 	Retorna as partes fracionárias e inteiras de x
trunc(x) 	Retorna o valor inteiro truncado de x
exp(x) 		Retorna e**x
expm1(x) 	Retorna e**x - 1
log(x[, b]) 	Retorna o logaritmo de x para a base b (o padrão é e)
log1p(x) 	Retorna o logaritmo natural de 1+x
log2(x) 	Retorna o logaritmo de base 2 de x
log10(x) 	Retorna o logaritmo de base 10 de x
pow(x, y) 	Retorna x elevado à potência y
sqrt(x) 	Retorna a raiz quadrada de x
acos(x) 	Retorna o arco cosseno de x
asin(x) 	Retorna o arco seno de x
atan(x) 	Retorna o arco tangente de x
atan2(y, x) 	Retorna atan(y / x)
cos(x) 		Retorna o cosseno de x
hypot(x, y) 	Retorna a norma euclidiana, sqrt(x*x + y*y)
sin(x) 		Retorna o seno de x
tan(x) 		Retorna a tangente de x
degrees(x) 	Converte o ângulo x de radianos para graus
radians(x) 	Converte o ângulo x de graus para radianos
acosh(x) 	Retorna o cosseno hiperbólico inverso de x
asinh(x) 	Retorna o seno hiperbólico inverso de x
atanh(x) 	Retorna a tangente hiperbólica inversa de x
cosh(x) 	Retorna o cosseno hiperbólico de x
sinh(x) 	Retorna o cosseno hiperbólico de x
tanh(x) 	Retorna a tangente hiperbólica de x
erf(x) 		Retorna a função de erro em x
erfc(x) 	Retorna a função de erro complementar em x
gamma(x) 	Retorna a função Gamma em x
lgamma(x) 	Retorna o logaritmo natural do valor absoluto da função Gamma em x
pi 		Constante matemática, a razão entre a circunferência de um círculo e seu diâmetro (3,14159...)
e 		Constante matemática e (2,71828...)